R 1920 1080

NO textures/NO.xpm
SO textures/SO.xpm
WE textures/WE.xpm
EA textures/colorstone.xpm
S textures/ITEM.xpm

F 1,1,1
C 211,211,211

1111111111111111111111111
1000000000110000000000001
1011000001110000020S00001
1001000000000000000000001
1111111110110000011100001
1000000000110000011101111
1000000000000000110101001
1100000111010101111101111
1111111111111111111111111
